XXXXXXXXXXXXXXX
XX-T--------XXX
XXX---XXXT---XX
X----XXX----T-X
XT----XXXT--XXX
X---XXX----XXXX
X-T---XXXT--XXX
XXXXX---XXT---X
XP----XXXG---TX
XXXXXXXXXXXXXXX