XXXXXXXXXXXXXXX
XX-T--------XXX
XXX---XXXT---XX
X----XXX----T-X
XT----XXX---XXX
X---XXX----XXXX
X-T---XXXT--XXX
XXXXX---XX--T-X
XP----XXXG---TX
XXXXXXXXXXXXXXX