XXXXXXXXXXXXXXX
XX----------XXX
XXX---XXX----XX
X----XXX----T-X
XT----XXX---XXX
X---XXX----XXXX
X--T--XXXT--XXX
XXXXX---XX----X
XP----XXXG----X
XXXXXXXXXXXXXXX